player,teammate,games_together,wins_together,losses_together,win_rate
A Simple Femgirl,Boydardi,9,3,6,0.3333333333333333
A Simple Femgirl,Chow_Mitch,4,1,3,0.25
A Simple Femgirl,CoolNerdGames,9,3,6,0.3333333333333333
A Simple Femgirl,Creig1013,4,1,3,0.25
A Simple Femgirl,EricTheHispanic,5,2,3,0.4
A Simple Femgirl,Fastmadcow,5,2,3,0.4
A Simple Femgirl,Firefi6ht_RL,5,2,3,0.4
A Simple Femgirl,Recktals,5,2,3,0.4
A Simple Femgirl,SCATHEW XD,4,1,3,0.25
A Simple Femgirl,SpicyShinobi,5,2,3,0.4
A Simple Femgirl,bro.ro711,9,3,6,0.3333333333333333
A Simple Femgirl,brokeboy,5,2,3,0.4
A Simple Femgirl,enjay,4,1,3,0.25
A Simple Femgirl,enzo,5,2,3,0.4
A Simple Femgirl,zoarnyrl,4,1,3,0.25
AbSpectre,Ay_Ant,10,6,4,0.6
AbSpectre,Car-.-,4,3,1,0.75
AbSpectre,CoolNerdGames,5,2,3,0.4
AbSpectre,Creig1013,4,1,3,0.25
AbSpectre,Deciding,11,2,9,0.18181818181818182
AbSpectre,Eclipsed Frog,8,6,2,0.75
AbSpectre,EricTheHispanic,8,2,6,0.25
AbSpectre,Firefi6ht_RL,4,1,3,0.25
AbSpectre,Geo,4,3,1,0.75
AbSpectre,Groovy,3,3,0,1.0
AbSpectre,Preet,4,1,3,0.25
AbSpectre,RequitedZeus,4,1,3,0.25
AbSpectre,SCATHEW XD,5,2,3,0.4
AbSpectre,SpicyShinobi,3,3,0,1.0
AbSpectre,Tylanz,4,3,1,0.75
AbSpectre,chewy_chungus69,3,3,0,1.0
AiRblock8,CoolNerdGames,5,3,2,0.6
AiRblock8,enzo,5,3,2,0.6
Alpha_762,Beanzs2K,9,6,3,0.6666666666666666
Alpha_762,EricTheHispanic,5,3,2,0.6
Alpha_762,Firefi6ht_RL,24,18,6,0.75
Alpha_762,FriendlyFennec,6,0,6,0.0
Alpha_762,MerculesMilenial,8,3,5,0.375
Alpha_762,NMTotra,3,0,3,0.0
Alpha_762,Recktals,3,3,0,1.0
Alpha_762,SpicyShinobi,10,9,1,0.9
Alpha_762,TheRealDunion,3,0,3,0.0
Alpha_762,TheRyan.,6,3,3,0.5
Alpha_762,chewy_chungus69,7,1,6,0.14285714285714285
Alpha_762,tjdubya21,24,16,8,0.6666666666666666
Ascended!,Car-.-,3,3,0,1.0
Ascended!,FBISSsosa,17,11,6,0.6470588235294118
Ascended!,Goose,29,12,17,0.41379310344827586
Ascended!,ItsDaaes,8,2,6,0.25
Ascended!,JCISK,5,2,3,0.4
Ascended!,Maples,31,21,10,0.6774193548387096
Ascended!,Mateo,16,11,5,0.6875
Ascended!,MtnDru,9,5,4,0.5555555555555556
Ascended!,Nem,1,1,0,1.0
Ascended!,Yoky,3,0,3,0.0
Ascended!,bass!,15,8,7,0.5333333333333333
Ascended!,brokeboy,6,4,2,0.6666666666666666
Ascended!,ko!,8,3,5,0.375
Ascended!,nIMBUSXNZ^^,18,9,9,0.5
Ascended!,shack house,15,8,7,0.5333333333333333
Ascended!,sly,3,3,0,1.0
Ay_Ant,AbSpectre,10,6,4,0.6
Ay_Ant,Beanzs2K,13,6,7,0.46153846153846156
Ay_Ant,Deciding,3,0,3,0.0
Ay_Ant,Eclipsed Frog,7,3,4,0.42857142857142855
Ay_Ant,Firefi6ht_RL,5,2,3,0.4
Ay_Ant,FriendlyFennec,29,11,18,0.3793103448275862
Ay_Ant,Hedmarkers,3,3,0,1.0
Ay_Ant,Infantryboyz09,3,0,3,0.0
Ay_Ant,Memento Mori217,5,2,3,0.4
Ay_Ant,OGYeet_,14,5,9,0.35714285714285715
Ay_Ant,Preet,11,6,5,0.5454545454545454
Ay_Ant,RequitedZeus,5,2,3,0.4
Ay_Ant,"Shuk""!",6,6,0,1.0
Ay_Ant,Slik,3,3,0,1.0
Ay_Ant,SpicyShinobi,9,5,4,0.5555555555555556
Ay_Ant,Suduko,3,3,0,1.0
Ay_Ant,chewy_chungus69,20,8,12,0.4
Ay_Ant,dray (learning controller,4,3,1,0.75
Ay_Ant,enzo,7,4,3,0.5714285714285714
Ay_Ant,qFoal,9,4,5,0.4444444444444444
Ay_Ant,ski11acam,7,1,6,0.14285714285714285
Ay_Ant,tjdubya21,4,3,1,0.75
Beanzs2K,Alpha_762,9,6,3,0.6666666666666666
Beanzs2K,Ay_Ant,13,6,7,0.46153846153846156
Beanzs2K,EricTheHispanic,5,3,2,0.6
Beanzs2K,Firefi6ht_RL,5,3,2,0.6
Beanzs2K,FriendlyFennec,7,4,3,0.5714285714285714
Beanzs2K,NMTotra,3,3,0,1.0
Beanzs2K,OGYeet_,5,2,3,0.4
Beanzs2K,RequitedZeus,4,1,3,0.25
Beanzs2K,"Shuk""!",5,3,2,0.6
Beanzs2K,SpicyShinobi,12,7,5,0.5833333333333334
Beanzs2K,TheRealDunion,10,6,4,0.6
Beanzs2K,faBBenWh  y,8,6,2,0.75
Beanzs2K,tjdubya21,8,6,2,0.75
Bloom,Car-.-,8,6,2,0.75
Bloom,Goose,9,6,3,0.6666666666666666
Bloom,Groovy,3,0,3,0.0
Bloom,JCISK,5,3,2,0.6
Bloom,Maples,8,6,2,0.75
Bloom,Yoky,5,3,2,0.6
Bloom,bass!,4,1,3,0.25
Bloom,ko!,11,4,7,0.36363636363636365
Bloom,nIMBUSXNZ^^,3,3,0,1.0
Bloom,shack house,5,3,2,0.6
Bloom,sly,3,3,0,1.0
Bluegy,Boydardi,4,3,1,0.75
Bluegy,Fastmadcow,7,3,4,0.42857142857142855
Bluegy,"Shuk""!",3,0,3,0.0
Bluegy,Siem,6,0,6,0.0
Bluegy,enjay,4,3,1,0.75
Bluegy,zoarnyrl,4,3,1,0.75
Boydardi,A Simple Femgirl,9,3,6,0.3333333333333333
Boydardi,Bluegy,4,3,1,0.75
Boydardi,Car-.-,5,3,2,0.6
Boydardi,CoolNerdGames,5,2,3,0.4
Boydardi,DeltaJRomeo_,5,3,2,0.6
Boydardi,Eclipsed Frog,5,2,3,0.4
Boydardi,FBISSsosa,11,5,6,0.45454545454545453
Boydardi,Faith,3,0,3,0.0
Boydardi,Fastmadcow,13,6,7,0.46153846153846156
Boydardi,FuzzoL,8,2,6,0.25
Boydardi,Goose,14,8,6,0.5714285714285714
Boydardi,JCISK,4,1,3,0.25
Boydardi,Kyle$,8,2,6,0.25
Boydardi,Maples,1,0,1,0.0
Boydardi,MtnDru,8,6,2,0.75
Boydardi,SCATHEW XD,8,2,6,0.25
Boydardi,"Shuk""!",7,1,6,0.14285714285714285
Boydardi,Siem,4,1,3,0.25
Boydardi,Tylanz,8,6,2,0.75
Boydardi,Yoky,11,2,9,0.18181818181818182
Boydardi,brokeboy,1,0,1,0.0
Boydardi,enjay,4,3,1,0.75
Boydardi,ko!,1,0,1,0.0
Boydardi,nIMBUSXNZ^^,10,4,6,0.4
Boydardi,shack house,5,1,4,0.2
Boydardi,sly,9,2,7,0.2222222222222222
Boydardi,x0ffe,4,1,3,0.25
Boydardi,xMoNsTeRMaRiO,4,1,3,0.25
Boydardi,zoarnyrl,14,4,10,0.2857142857142857
Captain Wolfer,CoolNerdGames,3,3,0,1.0
Captain Wolfer,Deciding,3,3,0,1.0
Captain Wolfer,Eclipsed Frog,13,8,5,0.6153846153846154
Captain Wolfer,EricTheHispanic,8,6,2,0.75
Captain Wolfer,FriendlyFennec,14,6,8,0.42857142857142855
Captain Wolfer,Memento Mori217,3,3,0,1.0
Captain Wolfer,MerculesMilenial,3,0,3,0.0
Captain Wolfer,NMTotra,3,0,3,0.0
Captain Wolfer,Preet,9,6,3,0.6666666666666666
Captain Wolfer,RyanZeBlock,5,3,2,0.6
Captain Wolfer,"Shuk""!",5,3,2,0.6
Captain Wolfer,Suduko,5,2,3,0.4
Captain Wolfer,TheRealDunion,16,10,6,0.625
Captain Wolfer,Yoky,5,2,3,0.4
Captain Wolfer,chewy_chungus69,12,8,4,0.6666666666666666
Captain Wolfer,enzo,26,16,10,0.6153846153846154
Captain Wolfer,faBBenWh  y,5,2,3,0.4
Captain Wolfer,qFoal,4,3,1,0.75
Captain Wolfer,tjdubya21,8,6,2,0.75
Car-.-,AbSpectre,4,3,1,0.75
Car-.-,Ascended!,3,3,0,1.0
Car-.-,Bloom,8,6,2,0.75
Car-.-,Boydardi,5,3,2,0.6
Car-.-,CoolNerdGames,4,3,1,0.75
Car-.-,Creig1013,5,3,2,0.6
Car-.-,DeltaJRomeo_,5,3,2,0.6
Car-.-,Eclipsed Frog,4,3,1,0.75
Car-.-,EricTheHispanic,8,4,4,0.5
Car-.-,FBISSsosa,5,3,2,0.6
Car-.-,Faith,4,3,1,0.75
Car-.-,Fastmadcow,9,5,4,0.5555555555555556
Car-.-,Germ.,4,3,1,0.75
Car-.-,Goose,13,6,7,0.46153846153846156
Car-.-,ItsDaaes,5,3,2,0.6
Car-.-,JCISK,3,3,0,1.0
Car-.-,Maples,8,3,5,0.375
Car-.-,MtnDru,7,1,6,0.14285714285714285
Car-.-,No_Walt,4,3,1,0.75
Car-.-,Recktals,10,5,5,0.5
Car-.-,Ryan,4,1,3,0.25
Car-.-,"Shuk""!",5,3,2,0.6
Car-.-,TSabin.,5,3,2,0.6
Car-.-,Tylanz,5,3,2,0.6
Car-.-,bro.ro711,4,3,1,0.75
Car-.-,ko!,3,0,3,0.0
Car-.-,nIMBUSXNZ^^,12,6,6,0.5
Car-.-,shack house,14,9,5,0.6428571428571429
Car-.-,sly,10,7,3,0.7
Chow_Mitch,A Simple Femgirl,4,1,3,0.25
Chow_Mitch,Creig1013,4,1,3,0.25
Chow_Mitch,EricTheHispanic,14,2,12,0.14285714285714285
Chow_Mitch,Fastmadcow,4,3,1,0.75
Chow_Mitch,Firefi6ht_RL,4,1,3,0.25
Chow_Mitch,Germ.,4,1,3,0.25
Chow_Mitch,MerculesMilenial,4,1,3,0.25
Chow_Mitch,Suduko,4,3,1,0.75
Chow_Mitch,Yoky,5,3,2,0.6
Chow_Mitch,chiped.potato,8,2,6,0.25
Chow_Mitch,dray (learning controller,5,3,2,0.6
Chow_Mitch,enjay,4,1,3,0.25
Chow_Mitch,enzo,6,0,6,0.0
Cimino,FBISSsosa,6,3,3,0.5
Cimino,MtnDru,6,3,3,0.5
Cimino,ko!,4,3,1,0.75
Cimino,nIMBUSXNZ^^,4,3,1,0.75
CoolNerdGames,A Simple Femgirl,9,3,6,0.3333333333333333
CoolNerdGames,AbSpectre,5,2,3,0.4
CoolNerdGames,AiRblock8,5,3,2,0.6
CoolNerdGames,Boydardi,5,2,3,0.4
CoolNerdGames,Captain Wolfer,3,3,0,1.0
CoolNerdGames,Car-.-,4,3,1,0.75
CoolNerdGames,Deciding,3,0,3,0.0
CoolNerdGames,Eclipsed Frog,17,10,7,0.5882352941176471
CoolNerdGames,EricTheHispanic,3,0,3,0.0
CoolNerdGames,Firefi6ht_RL,14,7,7,0.5
CoolNerdGames,FriendlyFennec,3,0,3,0.0
CoolNerdGames,Germ.,9,6,3,0.6666666666666666
CoolNerdGames,Hedmarkers,3,0,3,0.0
CoolNerdGames,MtnDru,4,1,3,0.25
CoolNerdGames,No_Walt,5,3,2,0.6
CoolNerdGames,Preet,3,0,3,0.0
CoolNerdGames,Recktals,41,21,20,0.5121951219512195
CoolNerdGames,Ryan,5,1,4,0.2
CoolNerdGames,SCATHEW XD,9,3,6,0.3333333333333333
CoolNerdGames,"Shuk""!",17,10,7,0.5882352941176471
CoolNerdGames,Siem,4,1,3,0.25
CoolNerdGames,Suduko,11,2,9,0.18181818181818182
CoolNerdGames,TheRealDunion,3,3,0,1.0
CoolNerdGames,Trickter02,3,3,0,1.0
CoolNerdGames,Yoky,3,0,3,0.0
CoolNerdGames,bro.ro711,5,3,2,0.6
CoolNerdGames,brokeboy,3,3,0,1.0
CoolNerdGames,enzo,26,10,16,0.38461538461538464
CoolNerdGames,faBBenWh  y,10,1,9,0.1
CoolNerdGames,qFoal,3,0,3,0.0
CoolNerdGames,ski11acam,3,3,0,1.0
CoolNerdGames,tjdubya21,6,0,6,0.0
CoolNerdGames,zoarnyrl,4,1,3,0.25
Creig1013,A Simple Femgirl,4,1,3,0.25
Creig1013,AbSpectre,4,1,3,0.25
Creig1013,Car-.-,5,3,2,0.6
Creig1013,Chow_Mitch,4,1,3,0.25
Creig1013,EricTheHispanic,4,1,3,0.25
Creig1013,Recktals,5,3,2,0.6
Creig1013,chewy_chungus69,3,3,0,1.0
Creig1013,qFoal,3,3,0,1.0
Deciding,AbSpectre,11,2,9,0.18181818181818182
Deciding,Ay_Ant,3,0,3,0.0
Deciding,Captain Wolfer,3,3,0,1.0
Deciding,CoolNerdGames,3,0,3,0.0
Deciding,FriendlyFennec,11,2,9,0.18181818181818182
Deciding,Hedmarkers,11,2,9,0.18181818181818182
Deciding,Memento Mori217,3,3,0,1.0
Deciding,OGYeet_,6,3,3,0.5
Deciding,Preet,7,1,6,0.14285714285714285
Deciding,Recktals,4,3,1,0.75
Deciding,RequitedZeus,4,1,3,0.25
Deciding,Ryan,5,2,3,0.4
Deciding,TweakingOut,10,6,4,0.6
Deciding,chewy_chungus69,10,6,4,0.6
Deciding,qFoal,3,3,0,1.0
Deciding,tjdubya21,18,11,7,0.6111111111111112
DeltaJRomeo_,Boydardi,5,3,2,0.6
DeltaJRomeo_,Car-.-,5,3,2,0.6
DeltaJRomeo_,Goose,3,0,3,0.0
DeltaJRomeo_,Kyle$,5,2,3,0.4
DeltaJRomeo_,Maples,4,3,1,0.75
DeltaJRomeo_,Nem,5,2,3,0.4
DeltaJRomeo_,Siem,4,3,1,0.75
DeltaJRomeo_,TSabin.,7,3,4,0.42857142857142855
DeltaJRomeo_,bass!,4,1,3,0.25
DeltaJRomeo_,nIMBUSXNZ^^,4,3,1,0.75
DeltaJRomeo_,sly,4,1,3,0.25
Eclipsed Frog,AbSpectre,8,6,2,0.75
Eclipsed Frog,Ay_Ant,7,3,4,0.42857142857142855
Eclipsed Frog,Boydardi,5,2,3,0.4
Eclipsed Frog,Captain Wolfer,13,8,5,0.6153846153846154
Eclipsed Frog,Car-.-,4,3,1,0.75
Eclipsed Frog,CoolNerdGames,17,10,7,0.5882352941176471
Eclipsed Frog,Fastmadcow,5,2,3,0.4
Eclipsed Frog,FriendlyFennec,16,6,10,0.375
Eclipsed Frog,Germ.,4,1,3,0.25
Eclipsed Frog,Recktals,10,6,4,0.6
Eclipsed Frog,Ryan,4,3,1,0.75
Eclipsed Frog,SCATHEW XD,4,1,3,0.25
Eclipsed Frog,"Shuk""!",4,1,3,0.25
Eclipsed Frog,SpicyShinobi,3,0,3,0.0
Eclipsed Frog,chewy_chungus69,5,2,3,0.4
Eclipsed Frog,tjdubya21,9,6,3,0.6666666666666666
EricTheHispanic,A Simple Femgirl,5,2,3,0.4
EricTheHispanic,AbSpectre,8,2,6,0.25
EricTheHispanic,Alpha_762,5,3,2,0.6
EricTheHispanic,Beanzs2K,5,3,2,0.6
EricTheHispanic,Captain Wolfer,8,6,2,0.75
EricTheHispanic,Car-.-,8,4,4,0.5
EricTheHispanic,Chow_Mitch,14,2,12,0.14285714285714285
EricTheHispanic,CoolNerdGames,3,0,3,0.0
EricTheHispanic,Creig1013,4,1,3,0.25
EricTheHispanic,Fastmadcow,4,3,1,0.75
EricTheHispanic,Firefi6ht_RL,27,14,13,0.5185185185185185
EricTheHispanic,No_Walt,4,3,1,0.75
EricTheHispanic,OGYeet_,3,3,0,1.0
EricTheHispanic,Recktals,4,3,1,0.75
EricTheHispanic,Ryan,7,4,3,0.5714285714285714
EricTheHispanic,SpicyShinobi,8,6,2,0.75
EricTheHispanic,TheRealDunion,8,6,2,0.75
EricTheHispanic,TheRyan.,4,3,1,0.75
EricTheHispanic,Yoky,10,6,4,0.6
EricTheHispanic,brokeboy,5,2,3,0.4
EricTheHispanic,chiped.potato,8,2,6,0.25
EricTheHispanic,enzo,9,0,9,0.0
EricTheHispanic,faBBenWh  y,4,1,3,0.25
EricTheHispanic,tjdubya21,5,3,2,0.6
FBISSsosa,Ascended!,17,11,6,0.6470588235294118
FBISSsosa,Boydardi,11,5,6,0.45454545454545453
FBISSsosa,Car-.-,5,3,2,0.6
FBISSsosa,Cimino,6,3,3,0.5
FBISSsosa,Faith,3,3,0,1.0
FBISSsosa,Fastmadcow,10,9,1,0.9
FBISSsosa,Goose,12,7,5,0.5833333333333334
FBISSsosa,ItsDaaes,20,13,7,0.65
FBISSsosa,Kyle$,4,1,3,0.25
FBISSsosa,Maples,15,8,7,0.5333333333333333
FBISSsosa,Mateo,7,6,1,0.8571428571428571
FBISSsosa,MtnDru,11,5,6,0.45454545454545453
FBISSsosa,RyanZeBlock,3,3,0,1.0
FBISSsosa,Tylanz,4,1,3,0.25
FBISSsosa,bass!,3,3,0,1.0
FBISSsosa,brokeboy,1,0,1,0.0
FBISSsosa,nIMBUSXNZ^^,4,3,1,0.75
FBISSsosa,shack house,15,8,7,0.5333333333333333
Faith,Boydardi,3,0,3,0.0
Faith,Car-.-,4,3,1,0.75
Faith,FBISSsosa,3,3,0,1.0
Faith,Mateo,14,5,9,0.35714285714285715
Faith,Siem,13,6,7,0.46153846153846156
Faith,TSabin.,4,3,1,0.75
Faith,bass!,7,4,3,0.5714285714285714
Faith,ko!,3,3,0,1.0
Faith,nIMBUSXNZ^^,4,1,3,0.25
Faith,shack house,16,9,7,0.5625
Faith,xMoNsTeRMaRiO,4,1,3,0.25
Faith,zoarnyrl,3,0,3,0.0
Fastmadcow,A Simple Femgirl,5,2,3,0.4
Fastmadcow,Bluegy,7,3,4,0.42857142857142855
Fastmadcow,Boydardi,13,6,7,0.46153846153846156
Fastmadcow,Car-.-,9,5,4,0.5555555555555556
Fastmadcow,Chow_Mitch,4,3,1,0.75
Fastmadcow,Eclipsed Frog,5,2,3,0.4
Fastmadcow,EricTheHispanic,4,3,1,0.75
Fastmadcow,FBISSsosa,10,9,1,0.9
Fastmadcow,Geo,4,3,1,0.75
Fastmadcow,ItsDaaes,15,8,7,0.5333333333333333
Fastmadcow,JCISK,4,1,3,0.25
Fastmadcow,Recktals,5,2,3,0.4
Fastmadcow,RyanZeBlock,6,6,0,1.0
Fastmadcow,Siem,3,0,3,0.0
Fastmadcow,SpicyShinobi,4,3,1,0.75
Fastmadcow,Suduko,4,3,1,0.75
Fastmadcow,bro.ro711,9,5,4,0.5555555555555556
Fastmadcow,enjay,15,12,3,0.8
Fastmadcow,ko!,3,0,3,0.0
Fastmadcow,nIMBUSXNZ^^,8,2,6,0.25
Fastmadcow,shack house,3,0,3,0.0
Firefi6ht_RL,A Simple Femgirl,5,2,3,0.4
Firefi6ht_RL,AbSpectre,4,1,3,0.25
Firefi6ht_RL,Alpha_762,24,18,6,0.75
Firefi6ht_RL,Ay_Ant,5,2,3,0.4
Firefi6ht_RL,Beanzs2K,5,3,2,0.6
Firefi6ht_RL,Chow_Mitch,4,1,3,0.25
Firefi6ht_RL,CoolNerdGames,14,7,7,0.5
Firefi6ht_RL,EricTheHispanic,27,14,13,0.5185185185185185
Firefi6ht_RL,FriendlyFennec,12,5,7,0.4166666666666667
Firefi6ht_RL,Groovy,5,3,2,0.6
Firefi6ht_RL,Hedmarkers,4,1,3,0.25
Firefi6ht_RL,Infantryboyz09,4,1,3,0.25
Firefi6ht_RL,Memento Mori217,3,0,3,0.0
Firefi6ht_RL,MerculesMilenial,5,3,2,0.6
Firefi6ht_RL,MtnDru,14,12,2,0.8571428571428571
Firefi6ht_RL,NMTotra,3,0,3,0.0
Firefi6ht_RL,No_Walt,5,3,2,0.6
Firefi6ht_RL,OGYeet_,8,3,5,0.375
Firefi6ht_RL,Preet,4,1,3,0.25
Firefi6ht_RL,Recktals,13,7,6,0.5384615384615384
Firefi6ht_RL,Ryan,23,9,14,0.391304347826087
Firefi6ht_RL,RyanZeBlock,5,2,3,0.4
Firefi6ht_RL,SCATHEW XD,10,4,6,0.4
Firefi6ht_RL,"Shuk""!",49,25,24,0.5102040816326531
Firefi6ht_RL,Slik,4,3,1,0.75
Firefi6ht_RL,SpicyShinobi,29,23,6,0.7931034482758621
Firefi6ht_RL,Suduko,11,3,8,0.2727272727272727
Firefi6ht_RL,TheRealDunion,5,2,3,0.4
Firefi6ht_RL,Yoky,23,15,8,0.6521739130434783
Firefi6ht_RL,bro.ro711,11,9,2,0.8181818181818182
Firefi6ht_RL,chewy_chungus69,8,2,6,0.25
Firefi6ht_RL,enjay,4,1,3,0.25
Firefi6ht_RL,enzo,20,12,8,0.6
Firefi6ht_RL,faBBenWh  y,4,1,3,0.25
Firefi6ht_RL,tjdubya21,27,21,6,0.7777777777777778
Firefi6ht_RL,zoarnyrl,4,3,1,0.75
FriendlyFennec,Alpha_762,6,0,6,0.0
FriendlyFennec,Ay_Ant,29,11,18,0.3793103448275862
FriendlyFennec,Beanzs2K,7,4,3,0.5714285714285714
FriendlyFennec,Captain Wolfer,14,6,8,0.42857142857142855
FriendlyFennec,CoolNerdGames,3,0,3,0.0
FriendlyFennec,Deciding,11,2,9,0.18181818181818182
FriendlyFennec,Eclipsed Frog,16,6,10,0.375
FriendlyFennec,Firefi6ht_RL,12,5,7,0.4166666666666667
FriendlyFennec,Hedmarkers,3,0,3,0.0
FriendlyFennec,Memento Mori217,12,5,7,0.4166666666666667
FriendlyFennec,NMTotra,10,4,6,0.4
FriendlyFennec,Recktals,5,3,2,0.6
FriendlyFennec,RequitedZeus,5,2,3,0.4
FriendlyFennec,Ryan,13,6,7,0.46153846153846156
FriendlyFennec,"Shuk""!",8,5,3,0.625
FriendlyFennec,SpicyShinobi,11,3,8,0.2727272727272727
FriendlyFennec,TheRealDunion,16,6,10,0.375
FriendlyFennec,TweakingOut,8,3,5,0.375
FriendlyFennec,chewy_chungus69,5,2,3,0.4
FriendlyFennec,enzo,18,7,11,0.3888888888888889
FriendlyFennec,tjdubya21,16,8,8,0.5
FuzzoL,Boydardi,8,2,6,0.25
FuzzoL,JCISK,5,3,2,0.6
FuzzoL,SCATHEW XD,4,1,3,0.25
FuzzoL,TSabin.,5,3,2,0.6
FuzzoL,Yoky,4,1,3,0.25
Geo,AbSpectre,4,3,1,0.75
Geo,Fastmadcow,4,3,1,0.75
Geo,Germ.,4,1,3,0.25
Geo,ItsDaaes,3,0,3,0.0
Geo,Nem,3,0,3,0.0
Geo,RyanZeBlock,3,3,0,1.0
Geo,Trickter02,10,5,5,0.5
Geo,Tylanz,4,3,1,0.75
Geo,dray (learning controller,4,1,3,0.25
Geo,enjay,7,6,1,0.8571428571428571
Geo,ko!,5,2,3,0.4
Geo,shack house,5,3,2,0.6
Germ.,Car-.-,4,3,1,0.75
Germ.,Chow_Mitch,4,1,3,0.25
Germ.,CoolNerdGames,9,6,3,0.6666666666666666
Germ.,Eclipsed Frog,4,1,3,0.25
Germ.,Geo,4,1,3,0.25
Germ.,MerculesMilenial,4,1,3,0.25
Germ.,"Shuk""!",4,1,3,0.25
Germ.,bro.ro711,5,3,2,0.6
Germ.,dray (learning controller,4,1,3,0.25
Goose,Ascended!,29,12,17,0.41379310344827586
Goose,Bloom,9,6,3,0.6666666666666666
Goose,Boydardi,14,8,6,0.5714285714285714
Goose,Car-.-,13,6,7,0.46153846153846156
Goose,DeltaJRomeo_,3,0,3,0.0
Goose,FBISSsosa,12,7,5,0.5833333333333334
Goose,JCISK,3,0,3,0.0
Goose,Kyle$,4,1,3,0.25
Goose,Maples,19,11,8,0.5789473684210527
Goose,Mateo,5,2,3,0.4
Goose,Nem,11,7,4,0.6363636363636364
Goose,Siem,8,6,2,0.75
Goose,TSabin.,8,2,6,0.25
Goose,Ziyor,3,0,3,0.0
Goose,bass!,21,9,12,0.42857142857142855
Goose,brokeboy,1,0,1,0.0
Goose,ko!,13,6,7,0.46153846153846156
Goose,nIMBUSXNZ^^,26,10,16,0.38461538461538464
Goose,shack house,21,9,12,0.42857142857142855
Goose,sly,21,8,13,0.38095238095238093
Goose,x0ffe,8,6,2,0.75
Groovy,AbSpectre,3,3,0,1.0
Groovy,Bloom,3,0,3,0.0
Groovy,Firefi6ht_RL,5,3,2,0.6
Groovy,Siem,4,1,3,0.25
Groovy,SpicyShinobi,9,6,3,0.6666666666666666
Groovy,Suduko,4,3,1,0.75
Groovy,Yoky,12,9,3,0.75
Groovy,bass!,4,1,3,0.25
Groovy,enzo,3,0,3,0.0
Groovy,ko!,3,0,3,0.0
Groovy,shack house,4,1,3,0.25
Groovy,sly,4,1,3,0.25
Hedmarkers,Ay_Ant,3,3,0,1.0
Hedmarkers,CoolNerdGames,3,0,3,0.0
Hedmarkers,Deciding,11,2,9,0.18181818181818182
Hedmarkers,Firefi6ht_RL,4,1,3,0.25
Hedmarkers,FriendlyFennec,3,0,3,0.0
Hedmarkers,Preet,10,1,9,0.1
Hedmarkers,enzo,3,3,0,1.0
Hedmarkers,tjdubya21,5,2,3,0.4
IceCreamBev,Maples,1,1,0,1.0
IceCreamBev,nIMBUSXNZ^^,1,1,0,1.0
Infantryboyz09,Ay_Ant,3,0,3,0.0
Infantryboyz09,Firefi6ht_RL,4,1,3,0.25
Infantryboyz09,Memento Mori217,5,2,3,0.4
Infantryboyz09,NMTotra,5,2,3,0.4
Infantryboyz09,OGYeet_,5,2,3,0.4
Infantryboyz09,Orange,5,2,3,0.4
Infantryboyz09,Preet,3,0,3,0.0
Infantryboyz09,Ryan,4,1,3,0.25
Infantryboyz09,Slik,3,3,0,1.0
Infantryboyz09,TheRealDunion,3,0,3,0.0
Infantryboyz09,TweakingOut,3,0,3,0.0
Infantryboyz09,chewy_chungus69,8,2,6,0.25
Infantryboyz09,ski11acam,3,0,3,0.0
Infantryboyz09,tjdubya21,8,5,3,0.625
ItsDaaes,Ascended!,8,2,6,0.25
ItsDaaes,Car-.-,5,3,2,0.6
ItsDaaes,FBISSsosa,20,13,7,0.65
ItsDaaes,Fastmadcow,15,8,7,0.5333333333333333
ItsDaaes,Geo,3,0,3,0.0
ItsDaaes,Nem,3,0,3,0.0
ItsDaaes,Tylanz,4,1,3,0.25
ItsDaaes,Yoky,3,0,3,0.0
ItsDaaes,nIMBUSXNZ^^,17,7,10,0.4117647058823529
JCISK,Ascended!,5,2,3,0.4
JCISK,Bloom,5,3,2,0.6
JCISK,Boydardi,4,1,3,0.25
JCISK,Car-.-,3,3,0,1.0
JCISK,Fastmadcow,4,1,3,0.25
JCISK,FuzzoL,5,3,2,0.6
JCISK,Goose,3,0,3,0.0
JCISK,Nem,3,0,3,0.0
JCISK,TSabin.,5,3,2,0.6
JCISK,nIMBUSXNZ^^,10,5,5,0.5
JCISK,shack house,22,12,10,0.5454545454545454
JCISK,xMoNsTeRMaRiO,3,3,0,1.0
Kyle$,Boydardi,8,2,6,0.25
Kyle$,DeltaJRomeo_,5,2,3,0.4
Kyle$,FBISSsosa,4,1,3,0.25
Kyle$,Goose,4,1,3,0.25
Kyle$,Nem,13,8,5,0.6153846153846154
Kyle$,ko!,4,3,1,0.75
Kyle$,nIMBUSXNZ^^,4,3,1,0.75
Kyle$,shack house,4,3,1,0.75
Kyle$,sly,4,3,1,0.75
Maples,Ascended!,31,21,10,0.6774193548387096
Maples,Bloom,8,6,2,0.75
Maples,Boydardi,1,0,1,0.0
Maples,Car-.-,8,3,5,0.375
Maples,DeltaJRomeo_,4,3,1,0.75
Maples,FBISSsosa,15,8,7,0.5333333333333333
Maples,Goose,19,11,8,0.5789473684210527
Maples,IceCreamBev,1,1,0,1.0
Maples,Mateo,8,6,2,0.75
Maples,Nem,4,3,1,0.75
Maples,Siem,4,3,1,0.75
Maples,Yoky,5,3,2,0.6
Maples,brokeboy,7,2,5,0.2857142857142857
Maples,ko!,3,0,3,0.0
Maples,nIMBUSXNZ^^,9,6,3,0.6666666666666666
Maples,shack house,16,7,9,0.4375
Maples,sly,5,2,3,0.4
Mateo,Ascended!,16,11,5,0.6875
Mateo,FBISSsosa,7,6,1,0.8571428571428571
Mateo,Faith,14,5,9,0.35714285714285715
Mateo,Goose,5,2,3,0.4
Mateo,Maples,8,6,2,0.75
Mateo,Siem,5,2,3,0.4
Mateo,TSabin.,13,9,4,0.6923076923076923
Mateo,bass!,4,3,1,0.75
Mateo,nIMBUSXNZ^^,13,7,6,0.5384615384615384
Mateo,shack house,19,10,9,0.5263157894736842
Mateo,sly,8,5,3,0.625
Mateo,xMoNsTeRMaRiO,8,2,6,0.25
Memento Mori217,Ay_Ant,5,2,3,0.4
Memento Mori217,Captain Wolfer,3,3,0,1.0
Memento Mori217,Deciding,3,3,0,1.0
Memento Mori217,Firefi6ht_RL,3,0,3,0.0
Memento Mori217,FriendlyFennec,12,5,7,0.4166666666666667
Memento Mori217,Infantryboyz09,5,2,3,0.4
Memento Mori217,NMTotra,5,2,3,0.4
Memento Mori217,"Shuk""!",5,3,2,0.6
Memento Mori217,SpicyShinobi,3,0,3,0.0
Memento Mori217,TheRealDunion,4,3,1,0.75
Memento Mori217,chewy_chungus69,13,4,9,0.3076923076923077
Memento Mori217,tjdubya21,5,3,2,0.6
MerculesMilenial,Alpha_762,8,3,5,0.375
MerculesMilenial,Captain Wolfer,3,0,3,0.0
MerculesMilenial,Chow_Mitch,4,1,3,0.25
MerculesMilenial,Firefi6ht_RL,5,3,2,0.6
MerculesMilenial,Germ.,4,1,3,0.25
MerculesMilenial,NMTotra,3,0,3,0.0
MerculesMilenial,OGYeet_,5,3,2,0.6
MerculesMilenial,TheRyan.,3,0,3,0.0
MerculesMilenial,chewy_chungus69,3,0,3,0.0
MerculesMilenial,tjdubya21,8,3,5,0.375
MtnDru,Ascended!,9,5,4,0.5555555555555556
MtnDru,Boydardi,8,6,2,0.75
MtnDru,Car-.-,7,1,6,0.14285714285714285
MtnDru,Cimino,6,3,3,0.5
MtnDru,CoolNerdGames,4,1,3,0.25
MtnDru,FBISSsosa,11,5,6,0.45454545454545453
MtnDru,Firefi6ht_RL,14,12,2,0.8571428571428571
MtnDru,SCATHEW XD,5,3,2,0.6
MtnDru,SpicyShinobi,14,12,2,0.8571428571428571
MtnDru,Suduko,4,1,3,0.25
MtnDru,Tylanz,8,6,2,0.75
MtnDru,Yoky,5,3,2,0.6
MtnDru,bro.ro711,5,3,2,0.6
MtnDru,enzo,5,3,2,0.6
MtnDru,ko!,4,3,1,0.75
MtnDru,shack house,6,0,6,0.0
MtnDru,sly,7,1,6,0.14285714285714285
NMTotra,Alpha_762,3,0,3,0.0
NMTotra,Beanzs2K,3,3,0,1.0
NMTotra,Captain Wolfer,3,0,3,0.0
NMTotra,Firefi6ht_RL,3,0,3,0.0
NMTotra,FriendlyFennec,10,4,6,0.4
NMTotra,Infantryboyz09,5,2,3,0.4
NMTotra,Memento Mori217,5,2,3,0.4
NMTotra,MerculesMilenial,3,0,3,0.0
NMTotra,OGYeet_,3,0,3,0.0
NMTotra,Orange,10,5,5,0.5
NMTotra,"Shuk""!",3,3,0,1.0
NMTotra,Slik,3,0,3,0.0
NMTotra,TheRealDunion,5,2,3,0.4
NMTotra,TweakingOut,3,0,3,0.0
NMTotra,bro.ro711,14,5,9,0.35714285714285715
NMTotra,chewy_chungus69,14,2,12,0.14285714285714285
NMTotra,faBBenWh  y,3,3,0,1.0
NMTotra,qFoal,5,3,2,0.6
Nem,Ascended!,1,1,0,1.0
Nem,DeltaJRomeo_,5,2,3,0.4
Nem,Geo,3,0,3,0.0
Nem,Goose,11,7,4,0.6363636363636364
Nem,ItsDaaes,3,0,3,0.0
Nem,JCISK,3,0,3,0.0
Nem,Kyle$,13,8,5,0.6153846153846154
Nem,Maples,4,3,1,0.75
Nem,bass!,1,1,0,1.0
Nem,shack house,11,7,4,0.6363636363636364
Nem,sly,8,4,4,0.5
No_Walt,Car-.-,4,3,1,0.75
No_Walt,CoolNerdGames,5,3,2,0.6
No_Walt,EricTheHispanic,4,3,1,0.75
No_Walt,Firefi6ht_RL,5,3,2,0.6
No_Walt,"Shuk""!",5,2,3,0.4
No_Walt,dray (learning controller,5,2,3,0.4
OGYeet_,Ay_Ant,14,5,9,0.35714285714285715
OGYeet_,Beanzs2K,5,2,3,0.4
OGYeet_,Deciding,6,3,3,0.5
OGYeet_,EricTheHispanic,3,3,0,1.0
OGYeet_,Firefi6ht_RL,8,3,5,0.375
OGYeet_,Infantryboyz09,5,2,3,0.4
OGYeet_,MerculesMilenial,5,3,2,0.6
OGYeet_,NMTotra,3,0,3,0.0
OGYeet_,Recktals,3,3,0,1.0
OGYeet_,Ryan,3,3,0,1.0
OGYeet_,SpicyShinobi,5,2,3,0.4
OGYeet_,chewy_chungus69,3,0,3,0.0
OGYeet_,qFoal,4,1,3,0.25
OGYeet_,ski11acam,8,5,3,0.625
OGYeet_,tjdubya21,13,7,6,0.5384615384615384
Orange,Infantryboyz09,5,2,3,0.4
Orange,NMTotra,10,5,5,0.5
Orange,qFoal,5,3,2,0.6
Preet,AbSpectre,4,1,3,0.25
Preet,Ay_Ant,11,6,5,0.5454545454545454
Preet,Captain Wolfer,9,6,3,0.6666666666666666
Preet,CoolNerdGames,3,0,3,0.0
Preet,Deciding,7,1,6,0.14285714285714285
Preet,Firefi6ht_RL,4,1,3,0.25
Preet,Hedmarkers,10,1,9,0.1
Preet,Infantryboyz09,3,0,3,0.0
Preet,Slik,7,6,1,0.8571428571428571
Preet,TheRealDunion,3,0,3,0.0
Preet,chewy_chungus69,12,6,6,0.5
Preet,enzo,9,6,3,0.6666666666666666
Preet,qFoal,10,6,4,0.6
Recktals,A Simple Femgirl,5,2,3,0.4
Recktals,Alpha_762,3,3,0,1.0
Recktals,Car-.-,10,5,5,0.5
Recktals,CoolNerdGames,41,21,20,0.5121951219512195
Recktals,Creig1013,5,3,2,0.6
Recktals,Deciding,4,3,1,0.75
Recktals,Eclipsed Frog,10,6,4,0.6
Recktals,EricTheHispanic,4,3,1,0.75
Recktals,Fastmadcow,5,2,3,0.4
Recktals,Firefi6ht_RL,13,7,6,0.5384615384615384
Recktals,FriendlyFennec,5,3,2,0.6
Recktals,OGYeet_,3,3,0,1.0
Recktals,Ryan,5,1,4,0.2
Recktals,"Shuk""!",10,6,4,0.6
Recktals,TheRyan.,3,3,0,1.0
Recktals,TweakingOut,5,3,2,0.6
Recktals,bro.ro711,4,3,1,0.75
Recktals,chewy_chungus69,11,9,2,0.8181818181818182
Recktals,enzo,23,12,11,0.5217391304347826
Recktals,ski11acam,6,6,0,1.0
Recktals,tjdubya21,6,6,0,1.0
RequitedZeus,AbSpectre,4,1,3,0.25
RequitedZeus,Ay_Ant,5,2,3,0.4
RequitedZeus,Beanzs2K,4,1,3,0.25
RequitedZeus,Deciding,4,1,3,0.25
RequitedZeus,FriendlyFennec,5,2,3,0.4
RequitedZeus,SpicyShinobi,4,1,3,0.25
RequitedZeus,qFoal,5,3,2,0.6
RequitedZeus,tjdubya21,5,3,2,0.6
Ryan,Car-.-,4,1,3,0.25
Ryan,CoolNerdGames,5,1,4,0.2
Ryan,Deciding,5,2,3,0.4
Ryan,Eclipsed Frog,4,3,1,0.75
Ryan,EricTheHispanic,10,4,6,0.4
Ryan,Firefi6ht_RL,23,9,14,0.391304347826087
Ryan,FriendlyFennec,13,6,7,0.46153846153846156
Ryan,Infantryboyz09,4,1,3,0.25
Ryan,OGYeet_,3,3,0,1.0
Ryan,Recktals,5,1,4,0.2
Ryan,RyanZeBlock,9,5,4,0.5555555555555556
Ryan,"Shuk""!",14,4,10,0.2857142857142857
Ryan,SpicyShinobi,3,0,3,0.0
Ryan,TheRyan.,3,0,3,0.0
Ryan,enzo,9,4,5,0.4444444444444444
Ryan,qFoal,1,1,0,1.0
Ryan,ski11acam,1,1,0,1.0
Ryan,tjdubya21,4,3,1,0.75
Ryan,zoarnyrl,4,1,3,0.25
RyanZeBlock,Captain Wolfer,5,3,2,0.6
RyanZeBlock,FBISSsosa,3,3,0,1.0
RyanZeBlock,Fastmadcow,6,6,0,1.0
RyanZeBlock,Firefi6ht_RL,5,2,3,0.4
RyanZeBlock,Geo,3,3,0,1.0
RyanZeBlock,Ryan,9,5,4,0.5555555555555556
RyanZeBlock,"Shuk""!",9,4,5,0.4444444444444444
RyanZeBlock,Siem,4,1,3,0.25
RyanZeBlock,enjay,6,6,0,1.0
RyanZeBlock,enzo,4,3,1,0.75
SCATHEW XD,A Simple Femgirl,4,1,3,0.25
SCATHEW XD,AbSpectre,5,2,3,0.4
SCATHEW XD,Boydardi,8,2,6,0.25
SCATHEW XD,CoolNerdGames,9,3,6,0.3333333333333333
SCATHEW XD,Eclipsed Frog,4,1,3,0.25
SCATHEW XD,Firefi6ht_RL,10,4,6,0.4
SCATHEW XD,FuzzoL,4,1,3,0.25
SCATHEW XD,MtnDru,5,3,2,0.6
SCATHEW XD,"Shuk""!",14,5,9,0.35714285714285715
SCATHEW XD,dray (learning controller,4,1,3,0.25
SCATHEW XD,enzo,5,3,2,0.6
"Shuk""!",Ay_Ant,6,6,0,1.0
"Shuk""!",Beanzs2K,5,3,2,0.6
"Shuk""!",Bluegy,3,0,3,0.0
"Shuk""!",Boydardi,7,1,6,0.14285714285714285
"Shuk""!",Captain Wolfer,5,3,2,0.6
"Shuk""!",Car-.-,5,3,2,0.6
"Shuk""!",CoolNerdGames,17,10,7,0.5882352941176471
"Shuk""!",Eclipsed Frog,4,1,3,0.25
"Shuk""!",Firefi6ht_RL,49,25,24,0.5102040816326531
"Shuk""!",FriendlyFennec,8,5,3,0.625
"Shuk""!",Germ.,4,1,3,0.25
"Shuk""!",Memento Mori217,5,3,2,0.6
"Shuk""!",NMTotra,3,3,0,1.0
"Shuk""!",No_Walt,5,2,3,0.4
"Shuk""!",Recktals,10,6,4,0.6
"Shuk""!",Ryan,14,4,10,0.2857142857142857
"Shuk""!",RyanZeBlock,9,4,5,0.4444444444444444
"Shuk""!",SCATHEW XD,14,5,9,0.35714285714285715
"Shuk""!",Siem,15,5,10,0.3333333333333333
"Shuk""!",Suduko,14,6,8,0.42857142857142855
"Shuk""!",TheRealDunion,3,3,0,1.0
"Shuk""!",Tylanz,5,3,2,0.6
"Shuk""!",Yoky,6,0,6,0.0
"Shuk""!",Ziyor,5,2,3,0.4
"Shuk""!",bro.ro711,8,5,3,0.625
"Shuk""!",dray (learning controller,9,3,6,0.3333333333333333
"Shuk""!",enzo,9,6,3,0.6666666666666666
"Shuk""!",tjdubya21,10,5,5,0.5
"Shuk""!",x0ffe,4,1,3,0.25
"Shuk""!",zoarnyrl,16,10,6,0.625
Siem,Bluegy,6,0,6,0.0
Siem,Boydardi,4,1,3,0.25
Siem,CoolNerdGames,4,1,3,0.25
Siem,DeltaJRomeo_,4,3,1,0.75
Siem,Faith,13,6,7,0.46153846153846156
Siem,Fastmadcow,3,0,3,0.0
Siem,Goose,8,6,2,0.75
Siem,Groovy,4,1,3,0.25
Siem,Maples,4,3,1,0.75
Siem,Mateo,5,2,3,0.4
Siem,RyanZeBlock,4,1,3,0.25
Siem,"Shuk""!",15,5,10,0.3333333333333333
Siem,Suduko,3,3,0,1.0
Siem,TSabin.,4,3,1,0.75
Siem,Yoky,4,1,3,0.25
Siem,shack house,5,2,3,0.4
Siem,sly,4,1,3,0.25
Siem,x0ffe,8,6,2,0.75
Siem,zoarnyrl,7,6,1,0.8571428571428571
Slik,Ay_Ant,3,3,0,1.0
Slik,Firefi6ht_RL,4,3,1,0.75
Slik,Infantryboyz09,3,3,0,1.0
Slik,NMTotra,3,0,3,0.0
Slik,Preet,7,6,1,0.8571428571428571
Slik,bro.ro711,3,0,3,0.0
Slik,chewy_chungus69,4,3,1,0.75
Slik,qFoal,3,3,0,1.0
Slik,tjdubya21,10,9,1,0.9
SpicyShinobi,A Simple Femgirl,5,2,3,0.4
SpicyShinobi,AbSpectre,3,3,0,1.0
SpicyShinobi,Alpha_762,10,9,1,0.9
SpicyShinobi,Ay_Ant,9,5,4,0.5555555555555556
SpicyShinobi,Beanzs2K,12,7,5,0.5833333333333334
SpicyShinobi,Eclipsed Frog,3,0,3,0.0
SpicyShinobi,EricTheHispanic,8,6,2,0.75
SpicyShinobi,Fastmadcow,4,3,1,0.75
SpicyShinobi,Firefi6ht_RL,29,23,6,0.7931034482758621
SpicyShinobi,FriendlyFennec,11,3,8,0.2727272727272727
SpicyShinobi,Groovy,9,6,3,0.6666666666666666
SpicyShinobi,Memento Mori217,3,0,3,0.0
SpicyShinobi,MtnDru,14,12,2,0.8571428571428571
SpicyShinobi,OGYeet_,5,2,3,0.4
SpicyShinobi,RequitedZeus,4,1,3,0.25
SpicyShinobi,TheRyan.,4,3,1,0.75
SpicyShinobi,Yoky,7,6,1,0.8571428571428571
SpicyShinobi,chewy_chungus69,5,2,3,0.4
SpicyShinobi,enzo,13,5,8,0.38461538461538464
Suduko,Ay_Ant,3,3,0,1.0
Suduko,Captain Wolfer,5,2,3,0.4
Suduko,Chow_Mitch,4,3,1,0.75
Suduko,CoolNerdGames,11,2,9,0.18181818181818182
Suduko,Fastmadcow,4,3,1,0.75
Suduko,Firefi6ht_RL,11,3,8,0.2727272727272727
Suduko,Groovy,4,3,1,0.75
Suduko,MtnDru,4,1,3,0.25
Suduko,"Shuk""!",14,6,8,0.42857142857142855
Suduko,Siem,3,3,0,1.0
Suduko,Yoky,12,5,7,0.4166666666666667
Suduko,enzo,3,0,3,0.0
Suduko,faBBenWh  y,4,1,3,0.25
Suduko,qFoal,3,0,3,0.0
Suduko,zoarnyrl,3,3,0,1.0
TSabin.,Car-.-,5,3,2,0.6
TSabin.,DeltaJRomeo_,7,3,4,0.42857142857142855
TSabin.,Faith,4,3,1,0.75
TSabin.,FuzzoL,5,3,2,0.6
TSabin.,Goose,8,2,6,0.25
TSabin.,JCISK,5,3,2,0.6
TSabin.,Mateo,13,9,4,0.6923076923076923
TSabin.,Siem,4,3,1,0.75
TSabin.,Yoky,5,2,3,0.4
TSabin.,ko!,5,3,2,0.6
TSabin.,nIMBUSXNZ^^,24,13,11,0.5416666666666666
TSabin.,shack house,5,3,2,0.6
TSabin.,sly,3,3,0,1.0
TSabin.,xMoNsTeRMaRiO,5,3,2,0.6
TheRealDunion,Alpha_762,3,0,3,0.0
TheRealDunion,Beanzs2K,10,6,4,0.6
TheRealDunion,Captain Wolfer,16,10,6,0.625
TheRealDunion,CoolNerdGames,3,3,0,1.0
TheRealDunion,EricTheHispanic,8,6,2,0.75
TheRealDunion,Firefi6ht_RL,5,2,3,0.4
TheRealDunion,FriendlyFennec,16,6,10,0.375
TheRealDunion,Infantryboyz09,3,0,3,0.0
TheRealDunion,Memento Mori217,4,3,1,0.75
TheRealDunion,NMTotra,5,2,3,0.4
TheRealDunion,Preet,3,0,3,0.0
TheRealDunion,"Shuk""!",3,3,0,1.0
TheRealDunion,chewy_chungus69,5,2,3,0.4
TheRealDunion,faBBenWh  y,5,3,2,0.6
TheRealDunion,tjdubya21,9,6,3,0.6666666666666666
TheRyan.,Alpha_762,6,3,3,0.5
TheRyan.,EricTheHispanic,4,3,1,0.75
TheRyan.,MerculesMilenial,3,0,3,0.0
TheRyan.,Recktals,3,3,0,1.0
TheRyan.,SpicyShinobi,4,3,1,0.75
TheRyan.,qFoal,4,1,3,0.25
TheRyan.,ski11acam,4,1,3,0.25
Trickter02,CoolNerdGames,3,3,0,1.0
Trickter02,Geo,10,5,5,0.5
Trickter02,brokeboy,3,3,0,1.0
Trickter02,ko!,8,5,3,0.625
Trickter02,shack house,8,6,2,0.75
TweakingOut,Deciding,10,6,4,0.6
TweakingOut,FriendlyFennec,8,3,5,0.375
TweakingOut,Infantryboyz09,3,0,3,0.0
TweakingOut,NMTotra,3,0,3,0.0
TweakingOut,Recktals,5,3,2,0.6
TweakingOut,chewy_chungus69,6,0,6,0.0
TweakingOut,tjdubya21,13,6,7,0.46153846153846156
Tylanz,AbSpectre,4,3,1,0.75
Tylanz,Boydardi,8,6,2,0.75
Tylanz,Car-.-,5,3,2,0.6
Tylanz,FBISSsosa,4,1,3,0.25
Tylanz,Geo,4,3,1,0.75
Tylanz,ItsDaaes,4,1,3,0.25
Tylanz,MtnDru,8,6,2,0.75
Tylanz,"Shuk""!",5,3,2,0.6
Tylanz,Yoky,5,2,3,0.4
Tylanz,shack house,5,2,3,0.4
Yoky,Ascended!,3,0,3,0.0
Yoky,Bloom,5,3,2,0.6
Yoky,Boydardi,11,2,9,0.18181818181818182
Yoky,Captain Wolfer,5,2,3,0.4
Yoky,Chow_Mitch,5,3,2,0.6
Yoky,CoolNerdGames,3,0,3,0.0
Yoky,EricTheHispanic,10,6,4,0.6
Yoky,Firefi6ht_RL,23,15,8,0.6521739130434783
Yoky,FuzzoL,4,1,3,0.25
Yoky,Groovy,12,9,3,0.75
Yoky,ItsDaaes,3,0,3,0.0
Yoky,Maples,5,3,2,0.6
Yoky,MtnDru,5,3,2,0.6
Yoky,"Shuk""!",6,0,6,0.0
Yoky,Siem,4,1,3,0.25
Yoky,SpicyShinobi,7,6,1,0.8571428571428571
Yoky,Suduko,12,5,7,0.4166666666666667
Yoky,TSabin.,5,2,3,0.4
Yoky,Tylanz,5,2,3,0.4
Yoky,bro.ro711,8,6,2,0.75
Yoky,dray (learning controller,5,3,2,0.6
Yoky,enzo,10,6,4,0.6
Yoky,nIMBUSXNZ^^,5,2,3,0.4
Yoky,shack house,5,2,3,0.4
Ziyor,Goose,3,0,3,0.0
Ziyor,"Shuk""!",5,2,3,0.4
Ziyor,bass!,4,0,4,0.0
Ziyor,bro.ro711,5,2,3,0.4
Ziyor,ko!,3,0,3,0.0
Ziyor,nIMBUSXNZ^^,3,0,3,0.0
bass!,Ascended!,15,8,7,0.5333333333333333
bass!,Bloom,4,1,3,0.25
bass!,DeltaJRomeo_,4,1,3,0.25
bass!,FBISSsosa,3,3,0,1.0
bass!,Faith,7,4,3,0.5714285714285714
bass!,Goose,21,9,12,0.42857142857142855
bass!,Groovy,4,1,3,0.25
bass!,Mateo,4,3,1,0.75
bass!,Nem,1,1,0,1.0
bass!,Ziyor,4,0,4,0.0
bass!,ko!,17,6,11,0.35294117647058826
bass!,nIMBUSXNZ^^,18,7,11,0.3888888888888889
bass!,shack house,12,6,6,0.5
bass!,sly,8,2,6,0.25
bro.ro711,A Simple Femgirl,9,3,6,0.3333333333333333
bro.ro711,Car-.-,4,3,1,0.75
bro.ro711,CoolNerdGames,5,3,2,0.6
bro.ro711,Fastmadcow,9,5,4,0.5555555555555556
bro.ro711,Firefi6ht_RL,11,9,2,0.8181818181818182
bro.ro711,Germ.,5,3,2,0.6
bro.ro711,MtnDru,5,3,2,0.6
bro.ro711,NMTotra,14,5,9,0.35714285714285715
bro.ro711,Recktals,4,3,1,0.75
bro.ro711,"Shuk""!",8,5,3,0.625
bro.ro711,Slik,3,0,3,0.0
bro.ro711,Yoky,8,6,2,0.75
bro.ro711,Ziyor,5,2,3,0.4
bro.ro711,chewy_chungus69,16,8,8,0.5
bro.ro711,dray (learning controller,4,3,1,0.75
bro.ro711,enjay,4,1,3,0.25
bro.ro711,enzo,11,9,2,0.8181818181818182
bro.ro711,tjdubya21,3,3,0,1.0
brokeboy,A Simple Femgirl,5,2,3,0.4
brokeboy,Ascended!,6,4,2,0.6666666666666666
brokeboy,Boydardi,1,0,1,0.0
brokeboy,CoolNerdGames,3,3,0,1.0
brokeboy,EricTheHispanic,5,2,3,0.4
brokeboy,FBISSsosa,1,0,1,0.0
brokeboy,Goose,1,0,1,0.0
brokeboy,Maples,7,2,5,0.2857142857142857
brokeboy,Trickter02,3,3,0,1.0
brokeboy,nIMBUSXNZ^^,3,3,0,1.0
brokeboy,shack house,11,3,8,0.2727272727272727
chewy_chungus69,AbSpectre,3,3,0,1.0
chewy_chungus69,Alpha_762,7,1,6,0.14285714285714285
chewy_chungus69,Ay_Ant,20,8,12,0.4
chewy_chungus69,Captain Wolfer,12,8,4,0.6666666666666666
chewy_chungus69,Creig1013,3,3,0,1.0
chewy_chungus69,Deciding,10,6,4,0.6
chewy_chungus69,Eclipsed Frog,5,2,3,0.4
chewy_chungus69,Firefi6ht_RL,8,2,6,0.25
chewy_chungus69,FriendlyFennec,5,2,3,0.4
chewy_chungus69,Infantryboyz09,8,2,6,0.25
chewy_chungus69,Memento Mori217,13,4,9,0.3076923076923077
chewy_chungus69,MerculesMilenial,3,0,3,0.0
chewy_chungus69,NMTotra,14,2,12,0.14285714285714285
chewy_chungus69,OGYeet_,3,0,3,0.0
chewy_chungus69,Preet,12,6,6,0.5
chewy_chungus69,Recktals,11,9,2,0.8181818181818182
chewy_chungus69,Slik,4,3,1,0.75
chewy_chungus69,SpicyShinobi,5,2,3,0.4
chewy_chungus69,TheRealDunion,5,2,3,0.4
chewy_chungus69,TweakingOut,6,0,6,0.0
chewy_chungus69,bro.ro711,16,8,8,0.5
chewy_chungus69,dray (learning controller,4,3,1,0.75
chewy_chungus69,enzo,8,5,3,0.625
chewy_chungus69,qFoal,19,15,4,0.7894736842105263
chewy_chungus69,ski11acam,4,1,3,0.25
chewy_chungus69,tjdubya21,14,7,7,0.5
chiped.potato,Chow_Mitch,8,2,6,0.25
chiped.potato,EricTheHispanic,8,2,6,0.25
dray (learning controller,Ay_Ant,4,3,1,0.75
dray (learning controller,Chow_Mitch,5,3,2,0.6
dray (learning controller,Geo,4,1,3,0.25
dray (learning controller,Germ.,4,1,3,0.25
dray (learning controller,No_Walt,5,2,3,0.4
dray (learning controller,SCATHEW XD,4,1,3,0.25
dray (learning controller,"Shuk""!",9,3,6,0.3333333333333333
dray (learning controller,Yoky,5,3,2,0.6
dray (learning controller,bro.ro711,4,3,1,0.75
dray (learning controller,chewy_chungus69,4,3,1,0.75
dray (learning controller,qFoal,4,1,3,0.25
dray (learning controller,tjdubya21,8,4,4,0.5
enjay,A Simple Femgirl,4,1,3,0.25
enjay,Bluegy,4,3,1,0.75
enjay,Boydardi,4,3,1,0.75
enjay,Chow_Mitch,4,1,3,0.25
enjay,Fastmadcow,15,12,3,0.8
enjay,Firefi6ht_RL,4,1,3,0.25
enjay,Geo,7,6,1,0.8571428571428571
enjay,RyanZeBlock,6,6,0,1.0
enjay,bro.ro711,4,1,3,0.25
enzo,A Simple Femgirl,5,2,3,0.4
enzo,AiRblock8,5,3,2,0.6
enzo,Ay_Ant,7,4,3,0.5714285714285714
enzo,Captain Wolfer,26,16,10,0.6153846153846154
enzo,Chow_Mitch,6,0,6,0.0
enzo,CoolNerdGames,26,10,16,0.38461538461538464
enzo,EricTheHispanic,9,0,9,0.0
enzo,Firefi6ht_RL,20,12,8,0.6
enzo,FriendlyFennec,18,7,11,0.3888888888888889
enzo,Groovy,3,0,3,0.0
enzo,Hedmarkers,3,3,0,1.0
enzo,MtnDru,5,3,2,0.6
enzo,Preet,9,6,3,0.6666666666666666
enzo,Recktals,23,12,11,0.5217391304347826
enzo,Ryan,9,4,5,0.4444444444444444
enzo,RyanZeBlock,4,3,1,0.75
enzo,SCATHEW XD,5,3,2,0.6
enzo,"Shuk""!",9,6,3,0.6666666666666666
enzo,SpicyShinobi,13,5,8,0.38461538461538464
enzo,Suduko,3,0,3,0.0
enzo,Yoky,10,6,4,0.6
enzo,bro.ro711,11,9,2,0.8181818181818182
enzo,chewy_chungus69,8,5,3,0.625
enzo,faBBenWh  y,5,2,3,0.4
enzo,qFoal,4,1,3,0.25
enzo,tjdubya21,11,7,4,0.6363636363636364
enzo,zoarnyrl,4,3,1,0.75
faBBenWh  y,Beanzs2K,8,6,2,0.75
faBBenWh  y,Captain Wolfer,5,2,3,0.4
faBBenWh  y,CoolNerdGames,10,1,9,0.1
faBBenWh  y,EricTheHispanic,4,1,3,0.25
faBBenWh  y,Firefi6ht_RL,4,1,3,0.25
faBBenWh  y,NMTotra,3,3,0,1.0
faBBenWh  y,Suduko,4,1,3,0.25
faBBenWh  y,TheRealDunion,5,3,2,0.6
faBBenWh  y,enzo,5,2,3,0.4
faBBenWh  y,tjdubya21,6,0,6,0.0
ko!,Ascended!,8,3,5,0.375
ko!,Bloom,11,4,7,0.36363636363636365
ko!,Boydardi,1,0,1,0.0
ko!,Car-.-,3,0,3,0.0
ko!,Cimino,4,3,1,0.75
ko!,Faith,3,3,0,1.0
ko!,Fastmadcow,3,0,3,0.0
ko!,Geo,5,2,3,0.4
ko!,Goose,13,6,7,0.46153846153846156
ko!,Groovy,3,0,3,0.0
ko!,Kyle$,4,3,1,0.75
ko!,Maples,3,0,3,0.0
ko!,MtnDru,4,3,1,0.75
ko!,TSabin.,5,3,2,0.6
ko!,Trickter02,8,5,3,0.625
ko!,Ziyor,3,0,3,0.0
ko!,bass!,17,6,11,0.35294117647058826
ko!,nIMBUSXNZ^^,13,8,5,0.6153846153846154
ko!,shack house,9,6,3,0.6666666666666666
ko!,sly,1,0,1,0.0
ko!,xMoNsTeRMaRiO,5,3,2,0.6
nIMBUSXNZ^^,Ascended!,18,9,9,0.5
nIMBUSXNZ^^,Bloom,3,3,0,1.0
nIMBUSXNZ^^,Boydardi,10,4,6,0.4
nIMBUSXNZ^^,Car-.-,12,6,6,0.5
nIMBUSXNZ^^,Cimino,4,3,1,0.75
nIMBUSXNZ^^,DeltaJRomeo_,4,3,1,0.75
nIMBUSXNZ^^,FBISSsosa,4,3,1,0.75
nIMBUSXNZ^^,Faith,4,1,3,0.25
nIMBUSXNZ^^,Fastmadcow,8,2,6,0.25
nIMBUSXNZ^^,Goose,26,10,16,0.38461538461538464
nIMBUSXNZ^^,IceCreamBev,1,1,0,1.0
nIMBUSXNZ^^,ItsDaaes,17,7,10,0.4117647058823529
nIMBUSXNZ^^,JCISK,10,5,5,0.5
nIMBUSXNZ^^,Kyle$,4,3,1,0.75
nIMBUSXNZ^^,Maples,9,6,3,0.6666666666666666
nIMBUSXNZ^^,Mateo,13,7,6,0.5384615384615384
nIMBUSXNZ^^,TSabin.,24,13,11,0.5416666666666666
nIMBUSXNZ^^,Yoky,5,2,3,0.4
nIMBUSXNZ^^,Ziyor,3,0,3,0.0
nIMBUSXNZ^^,bass!,18,7,11,0.3888888888888889
nIMBUSXNZ^^,brokeboy,3,3,0,1.0
nIMBUSXNZ^^,ko!,13,8,5,0.6153846153846154
nIMBUSXNZ^^,shack house,9,6,3,0.6666666666666666
nIMBUSXNZ^^,sly,8,4,4,0.5
nIMBUSXNZ^^,xMoNsTeRMaRiO,4,1,3,0.25
nIMBUSXNZ^^,zoarnyrl,7,1,6,0.14285714285714285
qFoal,Ay_Ant,9,4,5,0.4444444444444444
qFoal,Captain Wolfer,4,3,1,0.75
qFoal,CoolNerdGames,3,0,3,0.0
qFoal,Creig1013,3,3,0,1.0
qFoal,Deciding,3,3,0,1.0
qFoal,NMTotra,5,3,2,0.6
qFoal,OGYeet_,4,1,3,0.25
qFoal,Orange,5,3,2,0.6
qFoal,Preet,10,6,4,0.6
qFoal,RequitedZeus,5,3,2,0.6
qFoal,Ryan,4,1,3,0.25
qFoal,Slik,3,3,0,1.0
qFoal,Suduko,3,0,3,0.0
qFoal,TheRyan.,4,1,3,0.25
qFoal,chewy_chungus69,19,15,4,0.7894736842105263
qFoal,dray (learning controller,4,1,3,0.25
qFoal,enzo,4,1,3,0.25
qFoal,ski11acam,8,2,6,0.25
qFoal,tjdubya21,20,11,9,0.55
shack house,Ascended!,15,8,7,0.5333333333333333
shack house,Bloom,5,3,2,0.6
shack house,Boydardi,5,1,4,0.2
shack house,Car-.-,14,9,5,0.6428571428571429
shack house,FBISSsosa,15,8,7,0.5333333333333333
shack house,Faith,16,9,7,0.5625
shack house,Fastmadcow,3,0,3,0.0
shack house,Geo,5,3,2,0.6
shack house,Goose,21,9,12,0.42857142857142855
shack house,Groovy,4,1,3,0.25
shack house,JCISK,22,12,10,0.5454545454545454
shack house,Kyle$,4,3,1,0.75
shack house,Maples,16,7,9,0.4375
shack house,Mateo,19,10,9,0.5263157894736842
shack house,MtnDru,6,0,6,0.0
shack house,Nem,11,7,4,0.6363636363636364
shack house,Siem,5,2,3,0.4
shack house,TSabin.,5,3,2,0.6
shack house,Trickter02,8,6,2,0.75
shack house,Tylanz,5,2,3,0.4
shack house,Yoky,5,2,3,0.4
shack house,bass!,12,6,6,0.5
shack house,brokeboy,11,3,8,0.2727272727272727
shack house,ko!,9,6,3,0.6666666666666666
shack house,nIMBUSXNZ^^,9,6,3,0.6666666666666666
shack house,sly,19,5,14,0.2631578947368421
shack house,x0ffe,1,1,0,1.0
shack house,xMoNsTeRMaRiO,3,3,0,1.0
ski11acam,Ay_Ant,7,1,6,0.14285714285714285
ski11acam,CoolNerdGames,3,3,0,1.0
ski11acam,Infantryboyz09,3,0,3,0.0
ski11acam,OGYeet_,8,5,3,0.625
ski11acam,Recktals,6,6,0,1.0
ski11acam,Ryan,4,1,3,0.25
ski11acam,TheRyan.,4,1,3,0.25
ski11acam,chewy_chungus69,4,1,3,0.25
ski11acam,qFoal,8,2,6,0.25
ski11acam,tjdubya21,5,2,3,0.4
sly,Ascended!,3,3,0,1.0
sly,Bloom,3,3,0,1.0
sly,Boydardi,9,2,7,0.2222222222222222
sly,Car-.-,10,7,3,0.7
sly,DeltaJRomeo_,4,1,3,0.25
sly,Goose,21,8,13,0.38095238095238093
sly,Groovy,4,1,3,0.25
sly,Kyle$,4,3,1,0.75
sly,Maples,5,2,3,0.4
sly,Mateo,8,5,3,0.625
sly,MtnDru,7,1,6,0.14285714285714285
sly,Nem,8,4,4,0.5
sly,Siem,4,1,3,0.25
sly,TSabin.,3,3,0,1.0
sly,bass!,8,2,6,0.25
sly,ko!,1,0,1,0.0
sly,nIMBUSXNZ^^,8,4,4,0.5
sly,shack house,19,5,14,0.2631578947368421
sly,xMoNsTeRMaRiO,4,1,3,0.25
tjdubya21,Alpha_762,24,16,8,0.6666666666666666
tjdubya21,Ay_Ant,4,3,1,0.75
tjdubya21,Beanzs2K,8,6,2,0.75
tjdubya21,Captain Wolfer,8,6,2,0.75
tjdubya21,CoolNerdGames,6,0,6,0.0
tjdubya21,Deciding,18,11,7,0.6111111111111112
tjdubya21,Eclipsed Frog,9,6,3,0.6666666666666666
tjdubya21,EricTheHispanic,5,3,2,0.6
tjdubya21,Firefi6ht_RL,27,21,6,0.7777777777777778
tjdubya21,FriendlyFennec,16,8,8,0.5
tjdubya21,Hedmarkers,5,2,3,0.4
tjdubya21,Infantryboyz09,8,5,3,0.625
tjdubya21,Memento Mori217,5,3,2,0.6
tjdubya21,MerculesMilenial,8,3,5,0.375
tjdubya21,OGYeet_,13,7,6,0.5384615384615384
tjdubya21,Recktals,6,6,0,1.0
tjdubya21,RequitedZeus,5,3,2,0.6
tjdubya21,Ryan,4,3,1,0.75
tjdubya21,"Shuk""!",10,5,5,0.5
tjdubya21,Slik,10,9,1,0.9
tjdubya21,TheRealDunion,9,6,3,0.6666666666666666
tjdubya21,TweakingOut,13,6,7,0.46153846153846156
tjdubya21,bro.ro711,3,3,0,1.0
tjdubya21,chewy_chungus69,14,7,7,0.5
tjdubya21,dray (learning controller,8,4,4,0.5
tjdubya21,enzo,11,7,4,0.6363636363636364
tjdubya21,faBBenWh  y,6,0,6,0.0
tjdubya21,qFoal,20,11,9,0.55
tjdubya21,ski11acam,5,2,3,0.4
x0ffe,Boydardi,4,1,3,0.25
x0ffe,Goose,8,6,2,0.75
x0ffe,"Shuk""!",4,1,3,0.25
x0ffe,Siem,8,6,2,0.75
x0ffe,shack house,1,1,0,1.0
xMoNsTeRMaRiO,Boydardi,4,1,3,0.25
xMoNsTeRMaRiO,Faith,4,1,3,0.25
xMoNsTeRMaRiO,JCISK,3,3,0,1.0
xMoNsTeRMaRiO,Mateo,8,2,6,0.25
xMoNsTeRMaRiO,TSabin.,5,3,2,0.6
xMoNsTeRMaRiO,ko!,5,3,2,0.6
xMoNsTeRMaRiO,nIMBUSXNZ^^,4,1,3,0.25
xMoNsTeRMaRiO,shack house,3,3,0,1.0
xMoNsTeRMaRiO,sly,4,1,3,0.25
zoarnyrl,A Simple Femgirl,4,1,3,0.25
zoarnyrl,Bluegy,4,3,1,0.75
zoarnyrl,Boydardi,14,4,10,0.2857142857142857
zoarnyrl,CoolNerdGames,4,1,3,0.25
zoarnyrl,Faith,3,0,3,0.0
zoarnyrl,Firefi6ht_RL,4,3,1,0.75
zoarnyrl,Ryan,4,1,3,0.25
zoarnyrl,"Shuk""!",16,10,6,0.625
zoarnyrl,Siem,7,6,1,0.8571428571428571
zoarnyrl,Suduko,3,3,0,1.0
zoarnyrl,enzo,4,3,1,0.75
zoarnyrl,nIMBUSXNZ^^,7,1,6,0.14285714285714285
